Work hard, and you will pass the test with flying colours,
	with flying colours		彩旗飘飘
	strike her colours		降旗投降
	go down with flying colours		虽败犹荣
	show your true colours	表现出你的本色
	Pass with flying colours	顺利通过考出好成绩
	
	I believe I can soor
	There are miracles in life I must achieve	
				生活中总有一些奇迹需要实现			
	high-flying		有雄心壮志的人
	a high zchiever 	通过努力取得成功的人
	a low achiever or underzchiever		成绩相对落后的人
	As you go though your day today, define own success, set
			you own and become. Today's the day!
	定义成功，设定目标，活在当下。
	Flashback	
	
	A for effort	劳而无功，出不少力但效果不理想
	make every effort to do something	尽一切努力
	spare no effort to do something 	不遗余力
	without effort		毫不费力
	last-ditch effort 	最后的努力
	all-our effort 		全力
	For here or to go!	在这吃还是带走
	wishful thinking	一厢情愿
	Give me a break 	放过我吧
	back to sqare one	退回原点，重新再来
	
	over the moon === extrenely pleased and happy	高兴万分,欣喜若狂
	once in a blue moon	罕见，难得，不常发生的事
	moonlight 	兼职
	promise sb . the moon 	夸下海口
	ask for the moon		想办不到的事情
	
	I simply have a lot an my plate right now!	有很多事要忙
	have too much his plate === to be up to one's in work
	=== to have one's hands full 	=== in the middle of something
	be tied up 		被占用
	
	drag racing		（汽车，摩托车的）直线加速赛
	sucks === to bad
	drag sb. dowm 	使某人沮丧
	drag sb's name through the mire/mud		把某人搞臭，使某人丢丑
	
	high and dry		孤立无援，陷入困境
	high horse			目中无人,自命清高
	get/be on one's high horse;	某人骄傲蛮横
	live high off the hog		生活富裕，过得很阔气
	eat high off/on the hog		大吃大喝
	high five  ===  give me five  击掌
	on the high 	心情好
	
	bang for his buck	货真价实。划算。物超所值
	with a bang 		砰的一声，的轰轰烈烈的，极其成功
	bang out 			匆忙赶出，当当地敲响
	da a bang-up job 	在某些事情上做的很不错
	
	work like a dog		苦干，拼命干，努力工作
	someone look likes a dog	长得跟狗一样
	between jobs		在待业
	headhunter			猎头公司
	land a good job		赢得工作
	land a big contract
	land the prize
	pay hike === salary raise	涨工资
	knock off === be off the work	停工下班
	get the ball rolling	=== to start sth		开始做某事
	
	
	start the ball rolling  	开始做某事
	keep the ball rolling		不中断，使活动不断进行
	roll one's sleeves up : to turn one's sleeves upward, exposing the arm.
		挽起袖子, 露出胳膊
	to perpare to get to work: be ready to take action
	roll in the aisles	=== 	laugh very hard 
		乐不可支，使捧腹大笑
	aisles			通道
	
	penny			一美分
	penny-ante		小本经营的,微薄的
	penny pincher	守财奴
	penny-wise		因小失大
	pound-foolish	贪小失大
	pretty penny	一笔数目可观的钱
	pennies from heaven 意外之财
	Pennies don't fall from heaven, they have ti be earned here on Earth
	nickel and dime		钱数较小的讨价还价==小本经营的
	a dime a dozen		表示某事容易得到
	
	This may be a great fire in our heart, yet no one ever comes to 
	warm himself at it, and the passers-by see only a wisp of smoke
	(每个人心里都有一团火，但路过的人只看到烟 -- 梵高)
	not worth a plugged nickel		一文不值，毫无价值
	don't take any wooden nickels	毫无价值,多保重(多用于好友再见)
	break the bank					河流决堤；耗尽资源，破产
	live from paycheck to paycheck  月光族
	max out somebody's credit card  刷爆信用卡；非常贵

	burn a hole in one's pocket		耗尽资源，破产
	burn the candle at both ends	挥霍体力与精力
	burn the midnight oil			点灯熬油，挑灯夜战

	Girly Girl						真女人，萌妹子
	urben Girl						标准女孩 				
	Tomboy							假小子
	girly room 						少女可爱房间
	toyboy							小白脸
	ladyboy							人妖
	Green Thumb			  宝贵才能<=>很会种花种菜的人
	greenhorn	=== greenhard		生手
	green with envy
	green-eyed monster
	green as jealousy				十分嫉妒

	play it by aar					见机行事
	play by the book				照章行事
	music to one's ear				高兴极了
	You'd better pratice			刻意练习
		
	play second fiddle				副手，处于次要位置
	play second banana				副手
	fiddle							小提琴，消磨时间
	lyre							竖琴
	pay the fiddler					承担费用;做坏事承担后果

	It take two to tango			孤掌难鸣；一个巴掌拍不响
	pass the bill					协商
	tangle 							争执，
	tangled up						纠缠在一起

	Aunt Sally						众矢之的
	a cheap shot					恶意中伤
	Aunt Tabby						不支持妇女运动的妇女
	Uncle Sam						山姆大叔;美国
	face the music					不得不接受惩罚
	take your medicine				忍受不愉快的事
	pay the piper					承担后果
	piper							风笛

	go for it 						大胆尝试
	give it the best shot			全力以赴
	grand slam						大满贯

	World Cup						世界杯
	on the ball						指人精明，能干
	Keep your eyes on the ball		保持谨觉
	throw a curve ball				造成意外的难题
	touch all bases					全面研究某问题;有进一步发展
	dropped the ball				失败
	fouled out						失败	
	knock the ball					达到某项成就

	on my game						状态好
	off my game						状态不好
	a whole new ball game			全新的挑战

	sound in body, sound in mind 	身心健康
	fit as a fiddle					身体健康;精神焕发
	full of bean == full of energy	
	early bird catches the worm		早行动，早成功

	sweat							汗水
	no sweat 轻而易举
	absent-mind						健忘
	don't sweat it = don't make a fuss 别大惊小怪

	hit the book = hard working
	hit it big : being successful

	make a pig of oneself			猛吃能喝，狼吞虎咽
	piggy bank						存钱罐，扑满
	3 pigs might fly/when pigs fly	不可能发生的事，无稽之谈
	make a pig's ear of sth / doing sth 把事情弄得一团糟
	make a silk purse out of a sow's ear 把劣质的东西变成高品质的东西
	sow									成年母猪
	sow 								播种
